PROYECTO 1 CRACK THE CODE

TRIVIA DE MÚSICA
- pop
  michael jackson - thiller 
  ariana grande  - thank you, next
  olivia rodrigo  - deja vu
  billie eillish  - bad guy
  harry style   - as it was
  sabrina carpenter  - please please please
  milena warton - warmisitay
  lady gaga      - bad romance
  rihanna      - umbrella
  adele       - someone like you 
  taylor swift - shake it off

- kpop
  bts         - dynamite
  stray kids  - god's menu
  blackpink   - how you like that
  twice       - the fells 
  txt         - back for more
  new jeans   - omg 
  lee serafim - smart

- reguetoon
  shakira     - sesión con bizarrap 
  bad bunny   - yo perreo sola
  becky g     - mayores
  karol  g    - tusa
  raw alejandro  - santa
  tini         - carne y hueso 
  maria becerra - miénteme
  chris mj      - gata only
  mike towers   - lalalalalala
  anuel  - china
  mora   - un deseo
  feid  - la inocente
     

- salsa
  oscar de leon - lloraras
  celia cruz  - yo viviré
  hector lavo  - el día de mi suerte
  marck antony   - vivir mi vida
  willie colón - el gran varón 
  jerry rivera - que hay de malo
  maelo ruiz  -  te va a doler
  daniela darcourt - señor mentira 
  frankie ruiz  - tú con él


  
  